1111111111111111111
1000000000E00000000
1000000000000000000
1000000000P00000000
1000000000000000001
10000N0000000000000
11111111111111111111