11111111111111111111
1000000000E000000001
10000000000000000001
1000000000P000000001
10000000000000000011
10000N0N000000000C01
11111111111111111111