11111111111111111111
1000000000E000000001
10000000000000000001
1000000000P000000001
10000000000000000001
10000N0000C000000001
11111111111111111111