11111111
1EC00C01
1P00C111
10111111