11111111111111
1P0000000000E1
1C000000000001
10001111100001
10000000000001
10000000000001
111111111111111