111111111
1001
100000001
111111111