11111111111
10000000P11
11111111111