11111111111
100N0EC0001
1E000000P11
11111111111