11111111111
110000E00P1
11111111111