11111111111111
1P0000N000C0E1
1C0001C1000001
10000N00N00001
10C001C1000001
1000000000CN01
11111111111111