1111111111111111111
10P000C1C00011C0111
10C1C001110011001C1
10110001E1011100001
101000010101110C001
1000100001C00000001
10C0110001111111001
1000110000000C00001
1111111111111111111