11111111111
10C00000P11
11111111111