1111111111111
1CN000N000101
11N0000000001
1000001P100E1
1111111111111