11111111111111
1P00000000C0E1
1C0001C1000001
10001111100001
10C001C1000001
10000000000C01
11111111111111