111111111
1P0000E01
1C00P0001
111111111