11111111111111
1P00000000C0E1
1C0001C1000001
10001111100C01
10C001C1000001
1000C00000C001
11111111111111