111111111
1P0000E01
1000P0001
111111111