1111111111111111111111
10P000C1C00011C0111C01
10C1C001110011001C1001
10110001E1011100000001
101000010101110C0000C1
1000100001C00000000001
10C0110001111111000C01
1000110000000C00000001
100C1100C0011111100001
100011C00000C000111111
1C000111111000000000C1
10C00000C011C111C00001
1111111100000111111111
1111111111111111111111