11111111111111111111
1000000000E000000001
10000000000000000001
1000000000P000000000
10000000000000000A01
1000000000C000000000
11111111111111111111